NO ./textures/north.xpm
SO ./textures/south.xpm
WE ./textures/west.xpm
EA ./textures/east.xpm

F 200,72,160
C 254,170,218

        1111111111111111111111111
        1000000000110000000000001
        1011000001110000N00000001
        1001000000000000000000011
111111111011000001110000000000001
100000000011000001110111100011111
11110111111111011100000010001
11110111111111011101010010001
11000000110101011100000010001
10000000000000001100000010001
10000000000000001101010010001
110000011101010111110111100111
11110111 1110101 101111 10001
11111111 1111111 111111111111